空空空空空空空空空空空空空
空砖空砖空砖空砖空砖空砖空
空砖空砖空砖空砖空砖空砖空
空砖空铁空砖空砖空铁空砖空
空砖空砖空砖空砖空砖空砖空
空空空铁空空铁空空铁空空空
铁空砖砖砖砖砖砖砖砖砖空铁
空空水水水水水水水水水空空
空空草草草草草草草草草空空
空空空空空空空空空空空空空
空空空空空空空空空空空空空
空空空空空空空空空空空空空
空空空空空空空空空空空空空
